R 1000 1000

NO ./resurs/textures/wall_one.xpm
SO ./resurs/textures/wall_two.xpm
WE ./resurs/textures/wall_three.xpm
EA ./resurs/textures/wall_four.xpm

C 53,76,78
F    55,41,38

S    ./resurs/textures/rick_3.xpm

        111111111111111111111111
        10000002201100000000002N1
        1011000001110000000000201
        1001000000000000000002001
111111111011000001110000000000001
100000000011000001110111111111111
11111111111111111111111111111
 
11111111111111111111111111111
11110111111111011100000010001
11110111111111011101010010001
11000000110101011100000010001
10000000000000001100000010001
10000000000000001101010010001
1100000111010101111101111000111
11110111 1110101 101111010001
11111111 1111111 111111111111
